CAGAAATACAGTGCGACCTG	CAGAAATACAGTGCGACCTG	1
CGATCCACAATTTTAAAAGA	CGATCCACAATTTTAAAAGA	1
ATCACATCTGTTTTAGAGCT	ATCACATCTGTTTTAGAGCT	1
TGTTGCAAGGCTAGTCCGTT	TGTTGCAAGGCTAGTCCGTT	1
CCAGAACGACCACGTCTGTT	CCAGAACGACCACGTCTGTT	1
TACCTTGGATCACTTACATC	TACCTTGGATCACTTACATC	1
CTTCAAGCTGTAATTCCGTA	CTTCAAGCTGTAATTCCGTA	1
TGAAAGTACTAGAAAACGTG	TGAAAGTACTAGAAAACGTG	1
TCTCACCGTGCTGTCACATT	TCTCACCGTGCTGTCACATT	1
GGGCGATGCACCGTTAATCG	GGGCGATGCACCGTTAATCG	1
CAGCTACTTCTTCCTTGCGC	CAGCTACTTCTTCCTTGCGC	1
CCTCTGACCTCAAGTTAAAA	CCTCTGACCTCAAGTTAAAA	1
TCTCCAAAATAAGGCTAGTC	TCTCCAAAATAAGGCTAGTC	5
TCCGCCGGGCGATCCGCCTG	TCCGCCGGGCGATCCGCCTG	1
CCCATCTCTTGTCTCTGTTT	CCCATCTCTTGTCTCTGTTT	1
CCCACCACTTATTTTTCCAC	CCCACCACTTATTTTTCCAC	1
TAAGCACGTTCGAGTCCATG	TAAGCACGTTCGAGTCCATG	1
ATTAGAGCTAGAAATAGCAA	ATTAGAGCTAGAAATAGCAA	1
TACGCTGACCTCCGCAACCT	TACGCTGACCTCCGCAACCT	1
GACTCCTATCATCATGTCGG	GACTCCTATCATCATGTCGG	4
CTACACAGATCCTTCCGTGA	CTACACAGATCCTTCCGTGA	1
ATCTTTCATGTCGAGACACA	ATCTTTCATGTCGAGACACA	1
CTTCACGATGCCAGCCGTTT	CTTCACGATGCCAGCCGTTT	1
ACCCGCGTCCTCGTCGTCGA	ACCCGCGTCCTCGTCGTCGA	1
TCCGCGCTTCCAGCCGCTCC	TCCGCGCTTCCAGCCGCTCC	1
TGTTCTTACCTGTGTTCGCG	TGTTCTTACCTGTGTTCGCG	1
TAGCCAGAAAACTTTACTCT	TAGCCAGAAAACTTTACTCT	1
CTCAAAATAGCGAGTTAAAA	CTCAAAATAGCGAGTTAAAA	5
CTCCAACCGTCCGTTATCAA	CTCCAACCGTCCGTTATCAA	2
CCGCGCACCACCGAGTCGGT	CCGCGCACCACCGAGTCGGT	3
TTTTGGGAGTACCGTGGACT	TTTTGGGAGTACCGTGGACT	1
AGTCCTGTCCCATGCGATTG	AGTCCTGTCCCATGCGATTG	1
CGCTGCCATCAACTTGAAAA	CGCTGCCATCAACTTGAAAA	6
CCTGCGTCCCGTGCAGGTGA	CCTGCGTCCCGTGCAGGTGA	1
GGGTAGTGACCCGTCCGTTA	GGGTAGTGACCCGTCCGTTA	2
CTTCAGTCCAAATGTAGCCG	CTTCAGTCCAAATGTAGCCG	1
CATGCCTCTTCATAGTTAAG	CATGCCTCTTCATAGTTAAG	1
TTCAGCAAGTTAAAATAAGG	TTCAGCAAGTTAAAATAAGG	6
CACGCTGACCCAGCCTATCG	CACGCTGACCCAGCCTATCG	1
TGCCGTCTTGGCGGGCCCCC	TGCCGTCTTGGCGGGCCCCC	1
CACGGTAACGGAGCGATTTG	CACGGTAACGGAGCGATTTG	1
TCCTCTCATGTGAAGTTATT	TCCTCTCATGTGAAGTTATT	1
CCAGCTTGTTCCTCTCCCCC	CCAGCTTGTTCCTCTCCCCC	1
GCTGTACCTGGAAAATCATG	GCTGTACCTGGAAAATCATG	1
TGCTTGGGCCGCTCCTCACA	TGCTTGGGCCGCTCCTCACA	1
GGGCAAGTCCGTTATCAACT	GGGCAAGTCCGTTATCAACT	4
GATGACACACCTGACCAGCC	GATGACACACCTGACCAGCC	1
TCTACATCTCCGACCACGTT	TCTACATCTCCGACCACGTT	1
CTGTCCGTTCTCAACTTGAA	CTGTCCGTTCTCAACTTGAA	4
GCAGAAGCGAGTAACATCGG	GCAGAAGCGAGTAACATCGG	1
GTGTCAATGGTCCATCGTTT	GTGTCAATGGTCCATCGTTT	1
TTATCGGCAGGCTATCCGTT	TTATCGGCAGGCTATCCGTT	3
CTGGAGTCACCCTACGTTGG	CTGGAGTCACCCTACGTTGG	1
TGCGTCAGTCGCCTACCTGT	TGCGTCAGTCGCCTACCTGT	1
GCTCACTCTCGCTCCTGTTT	GCTCACTCTCGCTCCTGTTT	1
CCAGTATTCCCACAATTTTA	CCAGTATTCCCACAATTTTA	1
CACTGTCCTGCACCGCCGTT	CACTGTCCTGCACCGCCGTT	1
AGATCATTGCTTTAGAGCTA	AGATCATTGCTTTAGAGCTA	1
CGATGACGTTACCGCAGCCG	CGATGACGTTACCGCAGCCG	1
ACCTTAATATTTGCCTCATC	ACCTTAATATTTGCCTCATC	1
GCTGCGAGCCCGTTATCAAC	GCTGCGAGCCCGTTATCAAC	4
TCCGGACGGTCTGCACGTGT	TCCGGACGGTCTGCACGTGT	2
CCCGTTTTAGTCTCAGCCCC	CCCGTTTTAGTCTCAGCCCC	1
GCTGTAGATCCGTCCGTCAG	GCTGTAGATCCGTCCGTCAG	1
TCGCTGTTCTCCTCCGTTTT	TCGCTGTTCTCCTCCGTTTT	1
TTGCCCTACAGATGCCTTCT	TTGCCCTACAGATGCCTTCT	1
CCACGGTGTTCATGCATGTG	CCACGGTGTTCATGCATGTG	1
GATGGCATCAATGAATCGCG	GATGGCATCAATGAATCGCG	1
CGGAGGCTCAAACATCGCGT	CGGAGGCTCAAACATCGCGT	2
ATTCCTTATCCCACCATCTC	ATTCCTTATCCCACCATCTC	1
GGTTTACAACTTGGAAAAGT	GGTTTACAACTTGGAAAAGT	1
GTCAGACCTAGTACCGCTAG	GTCAGACCTAGTACCGCTAG	1
CGTACGACCTGACAGCCAAG	CGTACGACCTGACAGCCAAG	1
GGCACGTTATCAACTTGAAA	GGCACGTTATCAACTTGAAA	5
TCACGACGCCGCCCCACTGG	TCACGACGCCGCCCCACTGG	1
CTATAACCACCTAGTACGTT	CTATAACCACCTAGTACGTT	1
CAACAAGCCATCAACGCCAG	CAACAAGCCATCAACGCCAG	1
TGACCAGCCACGCCCCTACA	TGACCAGCCACGCCCCTACA	1
TTGCAGGTCATTTGATCTTG	TTGCAGGTCATTTGATCTTG	1
TCGAAACCACAGATGTCCCT	TCGAAACCACAGATGTCCCT	1
TCTGTACGCGTGTTCCTTTG	TCTGTACGCGTGTTCCTTTG	1
CAGACACAGCGAGTCCGTTA	CAGACACAGCGAGTCCGTTA	2
ACCTGCAACGCTGCGCGCCG	ACCTGCAACGCTGCGCGCCG	1
GCTCGAGCAGCACACATCAT	GCTCGAGCAGCACACATCAT	1
ACGGGCTTGCCTTGACAAGT	ACGGGCTTGCCTTGACAAGT	1
TTTTCCGATTCCCGAGACCG	TTTTCCGATTCCCGAGACCG	1
CCGAGCGCATATGCCCAAGT	CCGAGCGCATATGCCCAAGT	1
AACCTTCAAAGGCCATCGTT	AACCTTCAAAGGCCATCGTT	1
ATATCGCTCTATTCTCCATG	ATATCGCTCTATTCTCCATG	1
CTCACTCATATCTTTCCTGT	CTCACTCATATCTTTCCTGT	2
TCCAGAGAATTGTCATTTCG	TCCAGAGAATTGTCATTTCG	1
CCATTTTGGCTTCCACTTCC	CCATTTTGGCTTCCACTTCC	1
CTCCTGGGGCTTCTCAATCT	CTCCTGGGGCTTCTCAATCT	1
ACCCGATGAGCTGCGTCTCC	ACCCGATGAGCTGCGTCTCC	2
GTGCTAGAGATAGCAAGTTA	GTGCTAGAGATAGCAAGTTA	1
CGCTGGCAAGTTAAAATAAG	CGCTGGCAAGTTAAAATAAG	2
ATCACATATCTTCATATTCC	ATCACATATCTTCATATTCC	1
CAATATTCTGAACTCCCCCG	CAATATTCTGAACTCCCCCG	1
TCCTCACCGTCAATCGCTAC	TCCTCACCGTCAATCGCTAC	1
GTCGCGCCACCCTTCCGTTT	GTCGCGCCACCCTTCCGTTT	1
CACTCTGTTTTTCAGCGTTC	CACTCTGTTTTTCAGCGTTC	1
TGCACGCTACTCCGTTATCA	TGCACGCTACTCCGTTATCA	10
CTGGGGTACCGAGTCGGTGC	CTGGGGTACCGAGTCGGTGC	1
TGAAATGTCTTCTAGATTTG	TGAAATGTCTTCTAGATTTG	1
ACCACCTAGAAATAGCAAGT	ACCACCTAGAAATAGCAAGT	1
TGCAGGCGGACACGATAGCC	TGCAGGCGGACACGATAGCC	1
CTGGACCACATAGTGACCTG	CTGGACCACATAGTGACCTG	1
TATTGCCCAGTGCGTCCACG	TATTGCCCAGTGCGTCCACG	1
TTCCCCTGATGCTCGTTTTA	TTCCCCTGATGCTCGTTTTA	1
CCCAGATAGCAAGTTAAAAT	CCCAGATAGCAAGTTAAAAT	1
GGACACGGTAGACGCTATCC	GGACACGGTAGACGCTATCC	1
TGACCACGTTCCCCCTGCAG	TGACCACGTTCCCCCTGCAG	3
GGCAATGAGGCTAGTCCGTT	GGCAATGAGGCTAGTCCGTT	2
ACCTTGCAACTTCACTGGTT	ACCTTGCAACTTCACTGGTT	1
TGTCCAACAGCGTCTCGTTT	TGTCCAACAGCGTCTCGTTT	1
CGGCAGTTATATCAAGGCCA	CGGCAGTTATATCAAGGCCA	1
ACCGAAGGTCCTTGAACAGT	ACCGAAGGTCCTTGAACAGT	1
GTTGGGCTCTGCGTCCTTCG	GTTGGGCTCTGCGTCCTTCG	1
CGCACCATCTCCCGGGGGTC	CGCACCATCTCCCGGGGGTC	1
CCATACTTCAGCGCAAGAAA	CCATACTTCAGCGCAAGAAA	1
CTGATTGAAACTCTTGTCAA	CTGATTGAAACTCTTGTCAA	1
ACTTACAACCCCGTCTCAGG	ACTTACAACCCCGTCTCAGG	1
ATCGGGCACAATACCACACT	ATCGGGCACAATACCACACT	1
GCTGGTCCGTTATCAACTTG	GCTGGTCCGTTATCAACTTG	1
AACCAGGGAGTGATGTTTTC	AACCAGGGAGTGATGTTTTC	1
ACTCACCCCACAGCATCCGT	ACTCACCCCACAGCATCCGT	1
ATGGGGTACCGAGTCGGTGC	ATGGGGTACCGAGTCGGTGC	1
GCACTATACTGCTTTGTCTT	GCACTATACTGCTTTGTCTT	1
CACCAGGGTTTCATTAACCT	CACCAGGGTTTCATTAACCT	1
ACTTGGTGAAGGGCAGGCCG	ACTTGGTGAAGGGCAGGCCG	4
CTGCACCACGTGCACCTCAT	CTGCACCACGTGCACCTCAT	1
CCTCGGTCCACACCGCCCAC	CCTCGGTCCACACCGCCCAC	1
GCAACTTGAAAAAGTGGCAC	GCAACTTGAAAAAGTGGCAC	1
ACCATTGCAGGTGCGGTTCA	ACCATTGCAGGTGCGGTTCA	1
CTGACACTTATATCTTATCT	CTGACACTTATATCTTATCT	1
CCCTGTGCAGCTATCCGTTA	CCCTGTGCAGCTATCCGTTA	2
CCGCTTCCACGTGTTCGACT	CCGCTTCCACGTGTTCGACT	1
CACGTCAAGAGCACGACCAG	CACGTCAAGAGCACGACCAG	1
TCGGCCTGGCGATATGGGCT	TCGGCCTGGCGATATGGGCT	1
AGGAACTGGATTTTTTATTG	AGGAACTGGATTTTTTATTG	1
AGTGTTGTCTGTGTCAGTGT	AGTGTTGTCTGTGTCAGTGT	1
TTAATGCATCTCAGCTGTTA	TTAATGCATCTCAGCTGTTA	1
GCGCCGCATTTAGAGCTAGA	GCGCCGCATTTAGAGCTAGA	1
TTGGGACATAGGTCTATCCG	TTGGGACATAGGTCTATCCG	1
CATAAAGCCATGGCTTGCCG	CATAAAGCCATGGCTTGCCG	1
GGGGTGGCTAACGTCCCGCG	GGGGTGGCTAACGTCCCGCG	1
TTCTTACCTTGGGGGTAGTC	TTCTTACCTTGGGGGTAGTC	6
CCGCAGAACCAAGTTAAAAT	CCGCAGAACCAAGTTAAAAT	1
TGACTGATTACCCGACTCCG	TGACTGATTACCCGACTCCG	1
GCGGGCGCACATGTCGCCTT	GCGGGCGCACATGTCGCCTT	1
CTTCAGGGTCTTTCCCCCTG	CTTCAGGGTCTTTCCCCCTG	1
AGCAACTTGAAAAAGTGGCA	AGCAACTTGAAAAAGTGGCA	4
CTGCTGTGCCGTGTGTGCTG	CTGCTGTGCCGTGTGTGCTG	2
TTTTAGAGCTAGAAATAGCA	TTTTAGAGCTAGAAATAGCA	1
TAGCCCCAGTAGTCCGTTAT	TAGCCCCAGTAGTCCGTTAT	4
CCAGGATGCCCGAATCCTCG	CCAGGATGCCCGAATCCTCG	1
GCTGCGAGCCCGTTCTCAAC	GCTGCGAGCCCGTTCTCAAC	1
TTGAACCATGTCACGGCCCT	TTGAACCATGTCACGGCCCT	1
CTTCTGCGAGCAGCTCACGG	CTTCTGCGAGCAGCTCACGG	1
ACAGATTATGCGAGAATGTC	ACAGATTATGCGAGAATGTC	1
CTCGCATTTGGTGATACACG	CTCGCATTTGGTGATACACG	1
ACCCGCCACATGCAGCTCGC	ACCCGCCACATGCAGCTCGC	1
CGAAGAGGGTTTGAGCCCAT	CGAAGAGGGTTTGAGCCCAT	1
GTACCAGCCGTCCGCCTCGT	GTACCAGCCGTCCGCCTCGT	1
TGTAGGAAAGACTTGAAACA	TGTAGGAAAGACTTGAAACA	1
CGCAGCCATGCATCCACTGT	CGCAGCCATGCATCCACTGT	1
ACGCATGATTCGGCCTCAAT	ACGCATGATTCGGCCTCAAT	1
CTTTCAGAAATAGCAAGTTA	CTTTCAGAAATAGCAAGTTA	1
GGAGGACCGTAGCACCCTCG	GGAGGACCGTAGCACCCTCG	1
TCCAGGCATTGATGGCCTTC	TCCAGGCATTGATGGCCTTC	1
CCACGTGTTTACGTGCCAGT	CCACGTGTTTACGTGCCAGT	1
CGGTGCGCAGGTAGCGCGTG	CGGTGCGCAGGTAGCGCGTG	1
ACGAAACACCGGACACACAG	ACGAAACACCGGACACACAG	1
TTTTTCAGCGTATGATCGGT	TTTTTCAGCGTATGATCGGT	1
CTTGACGCACCCCGCTCGCG	CTTGACGCACCCCGCTCGCG	1
CGTCACTGTCCAGCCCAGCG	CGTCACTGTCCAGCCCAGCG	1
ACTGCACATTGATCCTCGCT	ACTGCACATTGATCCTCGCT	1
CACTTGGGTCGCCGAGTTGG	CACTTGGGTCGCCGAGTTGG	1
CGATAATACAAATTTTACCG	CGATAATACAAATTTTACCG	1
ACCCGATGAGTTTCGTCTCC	ACCCGATGAGTTTCGTCTCC	1
CACCTCTCGATATGCATGAT	CACCTCTCGATATGCATGAT	1
TCCGGGCGGTCTGCACGTGT	TCCGGGCGGTCTGCACGTGT	1
TCTCTCAGTGCCACGACATG	TCTCTCAGTGCCACGACATG	1
CCAGCAAGCCCGCAACTTTT	CCAGCAAGCCCGCAACTTTT	1
TTACTGTTGCCGCTCTTCCG	TTACTGTTGCCGCTCTTCCG	1
ATCCTGAAAATGCTATTTGT	ATCCTGAAAATGCTATTTGT	1
TCGTCAGCAACGATCCCTGT	TCGTCAGCAACGATCCCTGT	1
TTTTAAGGCAAGCAGAGTGT	TTTTAAGGCAAGCAGAGTGT	1
CGAGGGATACTTGTCACCTG	CGAGGGATACTTGTCACCTG	1
TCTGGGCATACGGGTGCATT	TCTGGGCATACGGGTGCATT	1
TTTTCCACCACTCGAATGCG	TTTTCCACCACTCGAATGCG	1
GGAGGGTGAGCCGTTTACTC	GGAGGGTGAGCCGTTTACTC	1
CATGTGCTCGCCATCATTCG	CATGTGCTCGCCATCATTCG	1
GCGGTAGAAACGTACCTTAT	GCGGTAGAAACGTACCTTAT	1
TGGATTGGTCGTTTCATTGT	TGGATTGGTCGTTTCATTGT	1
CCACTCGCACATCACCCGTT	CCACTCGCACATCACCCGTT	1
CATTACCATAACTGTCCGTT	CATTACCATAACTGTCCGTT	2
CTACACTCTCTTGCACGCCG	CTACACTCTCTTGCACGCCG	1
CCCATTGATCATACCGTCAG	CCCATTGATCATACCGTCAG	1
ATACCACCGACCTAACCGCG	ATACCACCGACCTAACCGCG	1
TCTTGTCCGTTATCAACTTG	TCTTGTCCGTTATCAACTTG	1
GATCGCAAGATCTGCGCAAT	GATCGCAAGATCTGCGCAAT	1
TCACTAGCATGAATCTTGAG	TCACTAGCATGAATCTTGAG	1
TTTAGATTTACAGCTAAATG	TTTAGATTTACAGCTAAATG	1
GCCAAGCCTACGTCCAAAGT	GCCAAGCCTACGTCCAAAGT	1
CGCAGGACAATCCCTCGTCC	CGCAGGACAATCCCTCGTCC	1
GAAGACTGTTAGAATGCCTA	GAAGACTGTTAGAATGCCTA	1
ACCGTCAACCATGAGAGCTA	ACCGTCAACCATGAGAGCTA	1
CCAGCACTCACCATGGCTGG	CCAGCACTCACCATGGCTGG	1
CGCAGCCATGCATCCACTCG	CGCAGCCATGCATCCACTCG	1
TTACTCAATTAATCGATGTA	TTACTCAATTAATCGATGTA	1
GCATGGTTCAGACCTCCCCC	GCATGGTTCAGACCTCCCCC	1
CTGCGTCATGCAACCAGCAA	CTGCGTCATGCAACCAGCAA	1
GGCTACATCGACTCGTCATG	GGCTACATCGACTCGTCATG	1
CCTGCTTCTGACTGTTAGAG	CCTGCTTCTGACTGTTAGAG	1
ATACAGTCCCTTTGTATTAG	ATACAGTCCCTTTGTATTAG	1
CACCGAGTATGTGGGCCGCC	CACCGAGTATGTGGGCCGCC	4
TTTTACAATGGCCACACCAG	TTTTACAATGGCCACACCAG	1
GCATTCTCCCACTGATGGTT	GCATTCTCCCACTGATGGTT	1
TCAGCAGAAGTCTACGCAGC	TCAGCAGAAGTCTACGCAGC	1
GCTTGACATTCTGCTTAGTT	GCTTGACATTCTGCTTAGTT	1
CCTCGAGGGATGAGCTCTTC	CCTCGAGGGATGAGCTCTTC	1
TCACCCAGTTCAACATCACG	TCACCCAGTTCAACATCACG	1
CTTCAAGTTAAAATAAGGCT	CTTCAAGTTAAAATAAGGCT	1
TCACTTCATACTGCTTCTCG	TCACTTCATACTGCTTCTCG	1
AGTCACCTACCCGCTGGTGC	AGTCACCTACCCGCTGGTGC	1
AACTGGGGCTGGCTTGTCAC	AACTGGGGCTGGCTTGTCAC	1
TCGATTGTGGCCGCTTCCTG	TCGATTGTGGCCGCTTCCTG	1
ACTGGACGTTGTCCACTTGA	ACTGGACGTTGTCCACTTGA	3
CGTTCGCCTCGTCTCAGGTA	CGTTCGCCTCGTCTCAGGTA	1
TCTGGCTACTCCGTTATCAA	TCTGGCTACTCCGTTATCAA	1
TTCCTCTAGTTCACCACCGT	TTCCTCTAGTTCACCACCGT	1
GGCCTCGCTCGCATAAGTCC	GGCCTCGCTCGCATAAGTCC	1
GACACTCTTGTTCTTGCAAC	GACACTCTTGTTCTTGCAAC	1
CCACTCTCTGATAAACTGTT	CCACTCTCTGATAAACTGTT	1
TGGGCTGCCGAGCATCTCTT	TGGGCTGCCGAGCATCTCTT	1
CGACTGCATATACTATGAAT	CGACTGCATATACTATGAAT	1
GGGCACCGTTGTTGCCAGCT	GGGCACCGTTGTTGCCAGCT	2
CCAGAGCCATCATGATCTTC	CCAGAGCCATCATGATCTTC	1
TATTCCCATCCAACATGTTC	TATTCCCATCCAACATGTTC	1
CGATGTCCACGTCTTATTGT	CGATGTCCACGTCTTATTGT	1
TAACCAAATTTTTCAACAAT	TAACCAAATTTTTCAACAAT	1
AAATGCCGACTTCTATCCGT	AAATGCCGACTTCTATCCGT	1
TCTTGTGTTTTAGAGCTAGA	TCTTGTGTTTTAGAGCTAGA	1
CGCGGACTCCGTCGCCGTCC	CGCGGACTCCGTCGCCGTCC	1
GCCCATCATGTTGAAGTCCG	GCCCATCATGTTGAAGTCCG	1
CATCAGCTTATTCCCAATAG	CATCAGCTTATTCCCAATAG	1
GTCACCAACTTCCTTTCTTG	GTCACCAACTTCCTTTCTTG	2
TGCTTCGAACTTTGTCATCG	TGCTTCGAACTTTGTCATCG	1
TTCTGAGCGGATCCCTCGCC	TTCTGAGCGGATCCCTCGCC	1
TTCCTCTTCTTCTGCCGTTT	TTCCTCTTCTTCTGCCGTTT	1
ACCTGTCGGCCAACCCAAGA	ACCTGTCGGCCAACCCAAGA	1
CGTCGTTGTTTGTGTCCCTT	CGTCGTTGTTTGTGTCCCTT	1
CTCATCCCCCCGCTTACCGG	CTCATCCCCCCGCTTACCGG	1
TTATGCCCTAGCCCCAAGCA	TTATGCCCTAGCCCCAAGCA	1
ACCCTTCCAGAACACACGTC	ACCCTTCCAGAACACACGTC	1
ATCGTCGTAACCCACAAGCA	ATCGTCGTAACCCACAAGCA	1
ATTCCTAGTTATCCGGTGTT	ATTCCTAGTTATCCGGTGTT	1
CCCCGACTTACTGGTCGAGG	CCCCGACTTACTGGTCGAGG	1
CCAGTTTTTCCTCGTCCTGT	CCAGTTTTTCCTCGTCCTGT	1
ACATAACCTCGATGACATAC	ACATAACCTCGATGACATAC	1
GGGCCGCCAAGAGATCGTCG	GGGCCGCCAAGAGATCGTCG	1
TAGTTATCAGTAGTTTAGAG	TAGTTATCAGTAGTTTAGAG	1
TATCTCCATCCAATGCCAGT	TATCTCCATCCAATGCCAGT	1
ACTCGGTCATGTGCTCGACG	ACTCGGTCATGTGCTCGACG	1
TGAAAGTACTAGAAAAAGTG	TGAAAGTACTAGAAAAAGTG	3
TAGAGCTAGAAATAGCAAGT	TAGAGCTAGAAATAGCAAGT	1
GAGCCATGGCGGCTGGTTTT	GAGCCATGGCGGCTGGTTTT	1
TGCGATCCTCAAGACACTGT	TGCGATCCTCAAGACACTGT	1
CGGACTTACCTGGACTGTGC	CGGACTTACCTGGACTGTGC	1
ATTTTCATTGACATACCAGT	ATTTTCATTGACATACCAGT	1
AGAAGTTCCTGCTGACGCCC	AGAAGTTCCTGCTGACGCCC	1
GCGGCACCGCCACAAAGCCC	GCGGCACCGCCACAAAGCCC	1
ATCAAAAAATGTACTTACTT	ATCAAAAAATGTACTTACTT	1
GCCCCATGTTCAGGGCGCGT	GCCCCATGTTCAGGGCGCGT	1
CAAGTGCATTGTTAGCTGAG	CAAGTGCATTGTTAGCTGAG	1
TGCTTTGGTACAAGCATCCT	TGCTTTGGTACAAGCATCCT	1
TTACCGGTCTTGCGTGCGTG	TTACCGGTCTTGCGTGCGTG	1
AAACGCCACCAATTCCAACC	AAACGCCACCAATTCCAACC	1
GTGACGAGCCTCTTGAAAAA	GTGACGAGCCTCTTGAAAAA	1
GCCCGTCAGCTCAAATCACC	GCCCGTCAGCTCAAATCACC	1
CCGCGAGCGACATGGGGGAT	CCGCGAGCGACATGGGGGAT	1
CTGTCCATTACGAGTGCCTC	CTGTCCATTACGAGTGCCTC	1
CACGATCCCCATCCCCCGCG	CACGATCCCCATCCCCCGCG	1
GATGCTCGACCTTGATAGGC	GATGCTCGACCTTGATAGGC	1
ACCTGAATGTAGAAAATAAG	ACCTGAATGTAGAAAATAAG	1
GCAAGTTAAAATAAGGCTAG	GCAAGTTAAAATAAGGCTAG	2
CTCATAGCAGTCCCGAGTAA	CTCATAGCAGTCCCGAGTAA	1
GAACTCACCACACCGGACAC	GAACTCACCACACCGGACAC	1
TCCATACCATTCCAGCCACG	TCCATACCATTCCAGCCACG	1
GTGAGTGCCCGATCCCGCTG	GTGAGTGCCCGATCCCGCTG	1
ACTGCACATTCTGAATATTT	ACTGCACATTCTGAATATTT	1
GTCGAGGCTGGCCCAGTGCG	GTCGAGGCTGGCCCAGTGCG	1
AGCAAGTTAAAATAAGGCTA	AGCAAGTTAAAATAAGGCTA	1
TAAGGCTAGTCCGTTATCAA	TAAGGCTAGTCCGTTATCAA	3
TGAACATCCATTTGCGCAGT	TGAACATCCATTTGCGCAGT	1
CTGCAACTCAAAGCCACGCG	CTGCAACTCAAAGCCACGCG	1
GGCCTTGTTCTGCTTGACCC	GGCCTTGTTCTGCTTGACCC	1
CCCACCCACCTTAGAGCTAG	CCCACCCACCTTAGAGCTAG	1
CTTTCCCTGCTCCTCATCTG	CTTTCCCTGCTCCTCATCTG	1
ACATGGAGTCTTGCACGTTT	ACATGGAGTCTTGCACGTTT	1
CACATCACCATGCGCCGTGT	CACATCACCATGCGCCGTGT	1
TACGCAGCCCGTCCCAAGCG	TACGCAGCCCGTCCCAAGCG	1
AGCCTTCAACATGATCACAG	AGCCTTCAACATGATCACAG	1
CTCACCGCGAACACTTTCTC	CTCACCGCGAACACTTTCTC	1
CCCAGCGTGCAATTCATAGT	CCCAGCGTGCAATTCATAGT	1
CGAAACGTCTCCCCGTGGTT	CGAAACGTCTCCCCGTGGTT	2
ACTTACTCTTCGATCCCCCG	ACTTACTCTTCGATCCCCCG	1
CCACTTCATTTACTGCCTGC	CCACTTCATTTACTGCCTGC	1
AGTGTTGTATTCCCAGTAAA	AGTGTTGTATTCCCAGTAAA	1
CGATGATTTAGAGCTAGAAA	CGATGATTTAGAGCTAGAAA	1
CTGTGCGACTCGCTCAGACC	CTGTGCGACTCGCTCAGACC	1
GCAGGTTATAATGCACTTCG	GCAGGTTATAATGCACTTCG	1
CATGGCTCCCCGTCGGGGAA	CATGGCTCCCCGTCGGGGAA	3
TCCAGCGACAGACCAACACT	TCCAGCGACAGACCAACACT	1
CTGCACGTCCTGCCAGCTCC	CTGCACGTCCTGCCAGCTCC	1
GTGTCCGAAAGTGTCTCACG	GTGTCCGAAAGTGTCTCACG	1
ACAATTGCGCTATGACTCTG	ACAATTGCGCTATGACTCTG	1
CCGTCATGCTGTCACCCTTG	CCGTCATGCTGTCACCCTTG	1
TCCGCTAGAGACTTGTGTGC	TCCGCTAGAGACTTGTGTGC	1
CCCTTCTCGTTGTACCCAGT	CCCTTCTCGTTGTACCCAGT	1
ATGCACAAATACACAATGAG	ATGCACAAATACACAATGAG	1
AGAATTCTATAGCCACCTCC	AGAATTCTATAGCCACCTCC	1
GATGGAGTGCAGACTTACGT	GATGGAGTGCAGACTTACGT	1
CTTCAGCCACATCAAATCAG	CTTCAGCCACATCAAATCAG	1
TAGGGATGCTTGGAGTTCCG	TAGGGATGCTTGGAGTTCCG	3
TTACAACAGGTAACAGCAGA	TTACAACAGGTAACAGCAGA	1
TTTATAGAGCACCTCAGCTT	TTTATAGAGCACCTCAGCTT	1
CACTAATGCAGGTCCGTTAT	CACTAATGCAGGTCCGTTAT	1
CTTGTGAACAGTGCCGTCTG	CTTGTGAACAGTGCCGTCTG	1
CTTCAACGGGACCTGGCTAG	CTTCAACGGGACCTGGCTAG	3
AGTTAAAATAAGGCTAGTCC	AGTTAAAATAAGGCTAGTCC	1
ATGACATCCACAATTTTAAA	ATGACATCCACAATTTTAAA	1
GAGCTGAAGTTCAAGTTACA	GAGCTGAAGTTCAAGTTACA	1
TCCCTGCGCTGACCGCGTTT	TCCCTGCGCTGACCGCGTTT	1
TGTGGCGACATCTCCGCCTT	TGTGGCGACATCTCCGCCTT	1
CCGGTATCCATCCTCCGTTA	CCGGTATCCATCCTCCGTTA	1
CATATGGAAATAGCAAGTTA	CATATGGAAATAGCAAGTTA	1
GCCCGGAGCGCTCGACCACG	GCCCGGAGCGCTCGACCACG	1
CTGTAGGATGTTGGGAACGT	CTGTAGGATGTTGGGAACGT	1
CACTCACCGTAGCCTTGTAA	CACTCACCGTAGCCTTGTAA	1
TTATCAGCTTGAAAAAGTGG	TTATCAGCTTGAAAAAGTGG	2
AACTTCGCTAAGCCGTTCCA	AACTTCGCTAAGCCGTTCCA	1
CATCCTTCATGTCGCCCGTG	CATCCTTCATGTCGCCCGTG	1
TGTCTCCACGATCTCAGCGT	TGTCTCCACGATCTCAGCGT	1
TACATATCCCCATGTTTCGT	TACATATCCCCATGTTTCGT	1
TCGATTCTGGTCTGGTTGTT	TCGATTCTGGTCTGGTTGTT	1
GCGGCTTCTTCTCGCACCCG	GCGGCTTCTTCTCGCACCCG	1
CTGCACCGCTCGGGAGGTTT	CTGCACCGCTCGGGAGGTTT	1
TCCGGCCCCACACTGACAGC	TCCGGCCCCACACTGACAGC	1
CAGCATACTTACTCTCTGCG	CAGCATACTTACTCTCTGCG	1
AGACTGATGCTTCGCTTCGT	AGACTGATGCTTCGCTTCGT	1
GGTGACGTGTCCTTCGTGAA	GGTGACGTGTCCTTCGTGAA	1
GGCTAGCCCGTTATCAACTT	GGCTAGCCCGTTATCAACTT	2
GCCCAACCACAGCATCAACA	GCCCAACCACAGCATCAACA	1
CCTGTACACCATCCACGTTT	CCTGTACACCATCCACGTTT	1
TCCCCCTGGTTTTAGAGCTA	TCCCCCTGGTTTTAGAGCTA	1
ACCTCCTCACCTGGGCTTGG	ACCTCCTCACCTGGGCTTGG	1
TTCGGTATGACGAGCAAGAT	TTCGGTATGACGAGCAAGAT	1
CAGCTATTCCTAGATGACCG	CAGCTATTCCTAGATGACCG	1
ATTCTGGCAGCTGTGCCTCG	ATTCTGGCAGCTGTGCCTCG	1
TTACCCTGCCCACACTCCTG	TTACCCTGCCCACACTCCTG	2
CTACCTTGCTCACAGCCGTT	CTACCTTGCTCACAGCCGTT	1
AGCAACTTGCAAAAGTGGCA	AGCAACTTGCAAAAGTGGCA	1
TCACCGGGCTAGGAGCATCG	TCACCGGGCTAGGAGCATCG	1
TCAACACTGTCACTGTGCCG	TCAACACTGTCACTGTGCCG	1
TACCTGCCCGCGGCGACTCG	TACCTGCCCGCGGCGACTCG	1
CTGTGTCGCGCTCCTGCAGT	CTGTGTCGCGCTCCTGCAGT	1
TCTGTTTCCAAGCCCTAGAA	TCTGTTTCCAAGCCCTAGAA	1
CCACCCCCACGATCCACGTT	CCACCCCCACGATCCACGTT	1
AACCTCACACAGCTGACTGT	AACCTCACACAGCTGACTGT	1
AGACCGCCTAAACCAACTCT	AGACCGCCTAAACCAACTCT	1
ACCCAACCGCAGCCTCGCCG	ACCCAACCGCAGCCTCGCCG	1
CTCCCTGCAACCCTCCCCGG	CTCCCTGCAACCCTCCCCGG	1
TTTTATCTGCCCATCGTTTA	TTTTATCTGCCCATCGTTTA	1
CTGCGGGAGCCATTCTGCAT	CTGCGGGAGCCATTCTGCAT	1
CCGACTTGACTTGCTCGGTT	CCGACTTGACTTGCTCGGTT	1
TAATTGCCTGCTCTCCCCTG	TAATTGCCTGCTCTCCCCTG	1
CCGCTGCATATGACCATTCC	CCGCTGCATATGACCATTCC	1
CTGATGTCTGTGCTGTCCTA	CTGATGTCTGTGCTGTCCTA	1
CTTACTGTTAGATTTATATT	CTTACTGTTAGATTTATATT	1
TAGTGCCGAGCTAGAAATAG	TAGTGCCGAGCTAGAAATAG	1
GCGAGCTTGGATCTGGACGG	GCGAGCTTGGATCTGGACGG	1
TGGACAGCCCAGGAGTCGTT	TGGACAGCCCAGGAGTCGTT	1
TCGCGACGTAGTACACGTGA	TCGCGACGTAGTACACGTGA	1
GGCCATCGAGCCACGGAGGT	GGCCATCGAGCCACGGAGGT	1
CGTCGTCGGCACCTTTGTCG	CGTCGTCGGCACCTTTGTCG	2
AGCGTATGAGTTTCACTGCC	AGCGTATGAGTTTCACTGCC	1
ACATAGAGCTAGAAATAGCA	ACATAGAGCTAGAAATAGCA	1
CCTCTCGCAACCAGTTCGAC	CCTCTCGCAACCAGTTCGAC	1
GCCTCACCCATGGCGACGGT	GCCTCACCCATGGCGACGGT	1
TTATAAACTTGAAAAAGTGG	TTATAAACTTGAAAAAGTGG	1
CTATCGGAGGTGTCATCGGT	CTATCGGAGGTGTCATCGGT	1
CACTCCGTGAGACAGGCCTT	CACTCCGTGAGACAGGCCTT	1
ACACTGACTACTTACACTTG	ACACTGACTACTTACACTTG	1
GCAGACGCAAACTGCCCTGT	GCAGACGCAAACTGCCCTGT	1
GATCGTCATTGCTCGGTTTT	GATCGTCATTGCTCGGTTTT	1
TCGTGTGACTGGAGCCACGA	TCGTGTGACTGGAGCCACGA	1
CCGCCACCCGTCTCATCCAT	CCGCCACCCGTCTCATCCAT	1
CTTTGATCAGCAAGTTAAAA	CTTTGATCAGCAAGTTAAAA	2
TCGCTACCAACTTGAAAAAG	TCGCTACCAACTTGAAAAAG	1
TGTTGAAAGACGAAGCCCGT	TGTTGAAAGACGAAGCCCGT	1
TACCAATTGATCTGCCGTTT	TACCAATTGATCTGCCGTTT	1
CCTTACCGTCTATCAGGCAC	CCTTACCGTCTATCAGGCAC	1
CTGAATGAAGGTGACCTTCA	CTGAATGAAGGTGACCTTCA	1
CCTGAGATCAGCTACTGCCG	CCTGAGATCAGCTACTGCCG	1
CTCGGATTTGCGCACGAGTG	CTCGGATTTGCGCACGAGTG	1
GTAGGCGAAGCTGCTGCTGT	GTAGGCGAAGCTGCTGCTGT	1
AAACTGCCCCACTCCTACTG	AAACTGCCCCACTCCTACTG	1
TGTCTTTCAGATTCATTTCG	TGTCTTTCAGATTCATTTCG	1
TACCTGCTTATAGCAAGTTA	TACCTGCTTATAGCAAGTTA	3
GCTGAATCCAAAGCCCGCCC	GCTGAATCCAAAGCCCGCCC	1
GGCTTGATTCTCTGAGCTCG	GGCTTGATTCTCTGAGCTCG	1
TGACCGAGCTGATGCCTTGA	TGACCGAGCTGATGCCTTGA	1
TGTTGCTGACGCAGTCTTCG	TGTTGCTGACGCAGTCTTCG	1
TGTACACCCCCCGGACCGTT	TGTACACCCCCCGGACCGTT	1
CATTGCTAGGTGAACCTGTT	CATTGCTAGGTGAACCTGTT	1
GACTACGTCAAATGCTGCAG	GACTACGTCAAATGCTGCAG	1
CTCTGGTCACATTGTTTTTA	CTCTGGTCACATTGTTTTTA	1
CCGCTGATGCTCGTAACAAT	CCGCTGATGCTCGTAACAAT	1
ATTGAAGCCACCCCAGCATC	ATTGAAGCCACCCCAGCATC	1
AGCCATGGCCCCTTCAGAAG	AGCCATGGCCCCTTCAGAAG	1
CACAGCGCATCGTGGAGGTT	CACAGCGCATCGTGGAGGTT	1
TACCTTGGCATAATCAATTT	TACCTTGGCATAATCAATTT	1
GTCGGATACGTCATCACGTT	GTCGGATACGTCATCACGTT	1
TCGATGATCCCGCTCCGTTT	TCGATGATCCCGCTCCGTTT	1
CTTTCGCCGATAGCAAGTTA	CTTTCGCCGATAGCAAGTTA	1
CGAGGCCATCAACGTGTCCG	CGAGGCCATCAACGTGTCCG	2
CATCATTCTCGGGCTTGTGA	CATCATTCTCGGGCTTGTGA	1
GAGCAAGGTCCGCTATCAAC	GAGCAAGGTCCGCTATCAAC	1
CCACATCATCAGACAACATA	CCACATCATCAGACAACATA	1
GTACCGAGTTGTGCCCTCGT	GTACCGAGTTGTGCCCTCGT	1
AGCGCATTGAGGCAGAATTC	AGCGCATTGAGGCAGAATTC	1
CCGTTATCATCAGCCATGCT	CCGTTATCATCAGCCATGCT	1
TCTTCACCTACTACACCGCT	TCTTCACCTACTACACCGCT	2
TCAGATGAACCTTACCTCCC	TCAGATGAACCTTACCTCCC	1
CATCGCACCCGCTGATCTTC	CATCGCACCCGCTGATCTTC	1
GATGCTGCAAGTTGCTTAGG	GATGCTGCAAGTTGCTTAGG	1
GCCCAACAATGCCGTTACGT	GCCCAACAATGCCGTTACGT	1
GCCCATCTGCTGCCTGCGCG	GCCCATCTGCTGCCTGCGCG	1
TACAGAGGGAGTCGCCATTG	TACAGAGGGAGTCGCCATTG	1
TCACGTTCGATGTCCGAGGT	TCACGTTCGATGTCCGAGGT	1
AGCATTATCTGTACATTCAC	AGCATTATCTGTACATTCAC	1
AACCTGCAATGATAGAGATT	AACCTGCAATGATAGAGATT	1
CAAGATCTAATAGCAAGTTA	CAAGATCTAATAGCAAGTTA	1
CAGCTATCATGTCACTAGCT	CAGCTATCATGTCACTAGCT	1
TCTGATATCAAAAGATTCGG	TCTGATATCAAAAGATTCGG	1
CGTGTGCTCTACGCCACTGT	CGTGTGCTCTACGCCACTGT	1
ACCCAGGCCAAATCCTAATT	ACCCAGGCCAAATCCTAATT	1
TTTAAGTGGATGCCCCTGAG	TTTAAGTGGATGCCCCTGAG	1
GTTGTAGGACAGTCGTGTTG	GTTGTAGGACAGTCGTGTTG	1
ACTCCTCCAGCTTCACACGT	ACTCCTCCAGCTTCACACGT	1
TTAACTGTTCCAGTGACCCT	TTAACTGTTCCAGTGACCCT	1
ACAAGATGCTGATCTTGCTG	ACAAGATGCTGATCTTGCTG	1
CCTGTCAACGTGAGCAGCAG	CCTGTCAACGTGAGCAGCAG	1
CCCGCACATCTACGCCTCAG	CCCGCACATCTACGCCTCAG	1
ACCGTCAGTTCATTATTTCT	ACCGTCAGTTCATTATTTCT	1
AACTTGTTACATTACCATCG	AACTTGTTACATTACCATCG	1
CGCCCGTGAACCACTTGGTT	CGCCCGTGAACCACTTGGTT	1
CACTGTCTTCCGTAATCAAC	CACTGTCTTCCGTAATCAAC	1
ACTTGTGAACTGCACACGTT	ACTTGTGAACTGCACACGTT	1
AACCAGATTCCACCAGAGTT	AACCAGATTCCACCAGAGTT	1
ACAGTGACAGCTCATGACTG	ACAGTGACAGCTCATGACTG	1
CATCTCCACTACGATGTGTT	CATCTCCACTACGATGTGTT	1
TTGTCCGGTAAACATCTTGT	TTGTCCGGTAAACATCTTGT	1
GATTTCAGGTCCCCTGGTTT	GATTTCAGGTCCCCTGGTTT	1
TCAGCCTGTCTGCGCTCGCG	TCAGCCTGTCTGCGCTCGCG	1
CTCCCCATCTACGTGTCGCG	CTCCCCATCTACGTGTCGCG	1
CTACTCCCAGGCTGATTGAG	CTACTCCCAGGCTGATTGAG	1
ATCTGCAGCGCCCCACACGG	ATCTGCAGCGCCCCACACGG	1
AACCATTTCCATCCTTCTTC	AACCATTTCCATCCTTCTTC	1
TGGAAATAGCAAGTTAAAAT	TGGAAATAGCAAGTTAAAAT	1
CTTGCAGCATGGCATTACAG	CTTGCAGCATGGCATTACAG	1
GTCATCGAACTACTCTTAGC	GTCATCGAACTACTCTTAGC	1
CTACCTTACCACGAGCAGTA	CTACCTTACCACGAGCAGTA	1
ACCGGTCCCATCTCCACACG	ACCGGTCCCATCTCCACACG	1
TGAGGTGCTTTTTTGAATTC	TGAGGTGCTTTTTTGAATTC	1
TACTCACCGATGACCTGTTT	TACTCACCGATGACCTGTTT	1
GGCTAAACTCATCCATTCTG	GGCTAAACTCATCCATTCTG	1
GACTTTTTCATCGTCATCGC	GACTTTTTCATCGTCATCGC	1
ACAGATCCTCTTCCGCCGCG	ACAGATCCTCTTCCGCCGCG	1
TTCTTTAGGAGCTTTTGGTT	TTCTTTAGGAGCTTTTGGTT	1
TAGGACAGCCGCATGCTTCG	TAGGACAGCCGCATGCTTCG	1
TTCCTGTTACCAGTTTTAGA	TTCCTGTTACCAGTTTTAGA	1
CGACCAGCCCTTCATCCGCG	CGACCAGCCCTTCATCCGCG	1
GAAAGGAAGTCTCGCCGAGG	GAAAGGAAGTCTCGCCGAGG	1
TTGCATAGAGCTAGAAATAG	TTGCATAGAGCTAGAAATAG	1
CAGGGGGCAGCACGGTGATC	CAGGGGGCAGCACGGTGATC	1
CACCACGTCACCATAACCGA	CACCACGTCACCATAACCGA	1
CCGACCGAAGCTGAATGTGG	CCGACCGAAGCTGAATGTGG	1
AACCACCTCTACCTGTATCG	AACCACCTCTACCTGTATCG	1
ACCAACTCAACTGTGAAGGT	ACCAACTCAACTGTGAAGGT	1
TAAGCACTTCTGCAACCTGT	TAAGCACTTCTGCAACCTGT	1
TCTGGGGACAGCTGGAGTCG	TCTGGGGACAGCTGGAGTCG	1
TTATCAACTTGAAAAAGTGG	TTATCAACTTGAAAAAGTGG	3
TGAGAGAAATCCTCCTTTAG	TGAGAGAAATCCTCCTTTAG	1
CGTCTATGATGACCTGCCCG	CGTCTATGATGACCTGCCCG	1
CCCAACAATACCACCGACCG	CCCAACAATACCACCGACCG	1
CACCCGTTTCCATGTCAACA	CACCCGTTTCCATGTCAACA	1
TATATTGCTCAAGTGACATA	TATATTGCTCAAGTGACATA	1
GCTAGTGTCCGGGATCTACT	GCTAGTGTCCGGGATCTACT	2
GACGGACGAGCGTCTGTAAC	GACGGACGAGCGTCTGTAAC	1
TCAGCAAGTTAAAATAAGGC	TCAGCAAGTTAAAATAAGGC	1
GAGGAGATGCTGTTCAACTA	GAGGAGATGCTGTTCAACTA	1
TCCCGTGAAACGAACTACAG	TCCCGTGAAACGAACTACAG	1
GCCCCAAGCTGTGTCCAATC	GCCCCAAGCTGTGTCCAATC	1
TAATACATACTGCACCATTG	TAATACATACTGCACCATTG	1
TTTCTGACAGGTGTTCACAG	TTTCTGACAGGTGTTCACAG	1
TGCTGTTTCAGACCTGACGT	TGCTGTTTCAGACCTGACGT	1
TGCGATCTCTGTGTTGGAAC	TGCGATCTCTGTGTTGGAAC	1
AGCCCACATGCTATCCACAG	AGCCCACATGCTATCCACAG	1
AACGCATCGTCACTGCATCT	AACGCATCGTCACTGCATCT	1
ACTCGCACAGCGCGTCAGAC	ACTCGCACAGCGCGTCAGAC	1
ACATGTCCCCGTGCCTCACG	ACATGTCCCCGTGCCTCACG	1
CCTTCTCGAAGTTGCCGTTT	CCTTCTCGAAGTTGCCGTTT	1
GCTCTCTGCAGCGCGGCGCG	GCTCTCTGCAGCGCGGCGCG	1
CGATCCTGTTATCAACTTGA	CGATCCTGTTATCAACTTGA	1
TTGGGCTGACCTGCGCCCTG	TTGGGCTGACCTGCGCCCTG	1
TGTCGCAGTTCGTGGGCCCT	TGTCGCAGTTCGTGGGCCCT	1
CACTCCCAGCATGAGTTTTA	CACTCCCAGCATGAGTTTTA	1
GGAGCTCTACAGAATAGAGC	GGAGCTCTACAGAATAGAGC	1
TCCGAGCTTCCAGCCGCTCC	TCCGAGCTTCCAGCCGCTCC	1
CACGTTTCAAAGTTCAAAGG	CACGTTTCAAAGTTCAAAGG	1
TGCTGCATGTCTGTGCCAGG	TGCTGCATGTCTGTGCCAGG	1
CCCGCTTCCATGAATCCGTT	CCCGCTTCCATGAATCCGTT	2
GGACTGTTCAGTTGATGTGC	GGACTGTTCAGTTGATGTGC	1
CAGCTCGGCCTCACCATCAG	CAGCTCGGCCTCACCATCAG	1
AGCTGGTGTACCTTGATGTT	AGCTGGTGTACCTTGATGTT	1
GGCAGACATCCCACTACGTT	GGCAGACATCCCACTACGTT	1
ACTGGTGCCAAACTCCTCGT	ACTGGTGCCAAACTCCTCGT	1
CGAGAAGCTCTGCTGAGTGC	CGAGAAGCTCTGCTGAGTGC	1
CCGTCCGTCCTCGTTCTTTA	CCGTCCGTCCTCGTTCTTTA	1
ACCCGATGAGTTGCGTCCCC	ACCCGATGAGTTGCGTCCCC	1
AATCCAACCAGCTAGAAATA	AATCCAACCAGCTAGAAATA	1
AACTCTCCCACCATTACATC	AACTCTCCCACCATTACATC	1
AGTGCTGAGTTCATTGCAGG	AGTGCTGAGTTCATTGCAGG	1
CTGCGCCTTTGTCATCGCCT	CTGCGCCTTTGTCATCGCCT	1
TGTCATCATGATGTCCTTTC	TGTCATCATGATGTCCTTTC	1
ACCCGCCTAACTTGAGCACT	ACCCGCCTAACTTGAGCACT	1
TCCATAGTAGGCTAGTCCGT	TCCATAGTAGGCTAGTCCGT	1
CGAATCAAATCCCGTTTGTG	CGAATCAAATCCCGTTTGTG	1
TGTTTGCAACATCTATGCCG	TGTTTGCAACATCTATGCCG	1
TCATGTACGCCTAAGAAAGT	TCATGTACGCCTAAGAAAGT	1
CACAGTTACATCGTGCGCCG	CACAGTTACATCGTGCGCCG	1
TTACACGCTCTTGCGTTTTG	TTACACGCTCTTGCGTTTTG	1
AGCAGTGAAACACATGTTTG	AGCAGTGAAACACATGTTTG	1
TAGTGCATCTGGAAGCTTGT	TAGTGCATCTGGAAGCTTGT	1
CGCGTTTTAGTCTCAGCTCC	CGCGTTTTAGTCTCAGCTCC	1
GTCCTGCTCACCCACATCGT	GTCCTGCTCACCCACATCGT	1
AGATTACCTGAAGCTTCTTC	AGATTACCTGAAGCTTCTTC	1
AGCACTCACAGAGGGGGTTG	AGCACTCACAGAGGGGGTTG	1
CAACGTCTATAGCCAGCTGG	CAACGTCTATAGCCAGCTGG	1
TTCACGACGTCCTGTATGTG	TTCACGACGTCCTGTATGTG	1
CTTTGTGACCCTGCAATCGT	CTTTGTGACCCTGCAATCGT	1
TTCATAATCAGGCGCTGCGT	TTCATAATCAGGCGCTGCGT	1
TCCCTTATTATGCTGCTTCG	TCCCTTATTATGCTGCTTCG	1
GTTGAGGTTGTCCAATCCGT	GTTGAGGTTGTCCAATCCGT	1
TGACTTAGAGCTAGAAATAG	TGACTTAGAGCTAGAAATAG	1
AGCCTAGTCCGTTATCAACT	AGCCTAGTCCGTTATCAACT	1
CCAATACTTTACACCTCCAG	CCAATACTTTACACCTCCAG	1
CAGGAACTGTGTGCCTACGG	CAGGAACTGTGTGCCTACGG	1
GACTGCGTGGCTCTACCCGT	GACTGCGTGGCTCTACCCGT	1
GGCAATAGCAAGCTAAAATA	GGCAATAGCAAGCTAAAATA	1
TGAGTGGCTACCAGCCAAGG	TGAGTGGCTACCAGCCAAGG	1
ATAGTCTAGATGTGCTTCAC	ATAGTCTAGATGTGCTTCAC	1
CTGCAAGCCCTGCTGTTCCC	CTGCAAGCCCTGCTGTTCCC	1
CAGGAGCACTCATTTGAGAT	CAGGAGCACTCATTTGAGAT	1
GCTGCTAGAACACCATTTAC	GCTGCTAGAACACCATTTAC	1
GCCGACATGCGCCCGCTTCG	GCCGACATGCGCCCGCTTCG	1
GAGCGTGGCTGACATACGGT	GAGCGTGGCTGACATACGGT	1
CGGAAGAACCACTGACTGTG	CGGAAGAACCACTGACTGTG	1
TGCTAAGTTCTGAGAGTTCA	TGCTAAGTTCTGAGAGTTCA	1
GGGCACCTCAATCTTCGTTT	GGGCACCTCAATCTTCGTTT	1
CGAACCTCTGAAGGTGCCGT	CGAACCTCTGAAGGTGCCGT	1
CAGCCCTCCACCGCTGTCGC	CAGCCCTCCACCGCTGTCGC	1
TTTATGCCTGGCACCTACTG	TTTATGCCTGGCACCTACTG	1
CTCATTATAGCTGCGACTCA	CTCATTATAGCTGCGACTCA	1
AGTCGGAAGCCCCTGGCAGT	AGTCGGAAGCCCCTGGCAGT	1
TCCTTTAAATAGCAAGTTAA	TCCTTTAAATAGCAAGTTAA	2
GCCTTCAAGAGCTCCCTTTA	GCCTTCAAGAGCTCCCTTTA	1
CGAGCAAGCTAAAATAAGGC	CGAGCAAGCTAAAATAAGGC	2
CGTGCTTCTAGGTTCCCTGT	CGTGCTTCTAGGTTCCCTGT	1
CAGAGTTTGAAGCCACGTCG	CAGAGTTTGAAGCCACGTCG	1
CTGACAGTGATTGACACACG	CTGACAGTGATTGACACACG	1
TACAGTCACATCTTGTTCGT	TACAGTCACATCTTGTTCGT	1
AGTTACTTTCTGAGCAGCAG	AGTTACTTTCTGAGCAGCAG	1
TTACTGTGTTTTAGAGCTAG	TTACTGTGTTTTAGAGCTAG	1
ACCTATTGCATCATTCCTGG	ACCTATTGCATCATTCCTGG	1
CTTCCTCACTAGAAATAGCA	CTTCCTCACTAGAAATAGCA	1
AGCGTGTCTAGGGCACCGCG	AGCGTGTCTAGGGCACCGCG	1
CATGAGCACGAAGCTGCTGT	CATGAGCACGAAGCTGCTGT	1
TGAGCAGCACTCGACCCACG	TGAGCAGCACTCGACCCACG	1
CAGTCCAAATGGCTCCCTTG	CAGTCCAAATGGCTCCCTTG	1
ATGCAGGCTACAGTAGATGC	ATGCAGGCTACAGTAGATGC	1
ACAGGGGTAGTTCATTCAGT	ACAGGGGTAGTTCATTCAGT	1
TTGTGTAGCTCTGTGCTTGG	TTGTGTAGCTCTGTGCTTGG	1
GGTCAGCCCGTTATCAACTT	GGTCAGCCCGTTATCAACTT	1
CTCGGTGCCTACTTCGTCGA	CTCGGTGCCTACTTCGTCGA	1
TTAATCAAACTTGAAAAAGT	TTAATCAAACTTGAAAAAGT	1
AGCGACCGTCTGTGGTGTTT	AGCGACCGTCTGTGGTGTTT	1
TTAGAGAAGATCCATCATTT	TTAGAGAAGATCCATCATTT	1
ATTTCGTCGTAAAATTGCCG	ATTTCGTCGTAAAATTGCCG	1
TTCAGATGATACAAAAAAAT	TTCAGATGATACAAAAAAAT	1
CCACATGGGGAAAGAATTCA	CCACATGGGGAAAGAATTCA	1
TCAATCAAGTTAAAACAAGG	TCAATCAAGTTAAAACAAGG	1
ATTTTCCAAGCCTACCCATG	ATTTTCCAAGCCTACCCATG	1
TTTACAACCCTTCAGACCTG	TTTACAACCCTTCAGACCTG	1
GATTACGTATTCCTGCAACG	GATTACGTATTCCTGCAACG	1
AATATTAAACAAATCTGGGG	AATATTAAACAAATCTGGGG	1
CTGAGGGTAGCAAGTTAAAA	CTGAGGGTAGCAAGTTAAAA	1
TGTCTAGTCGCTGTCTGAGG	TGTCTAGTCGCTGTCTGAGG	1
CTTACAGCCCAAATTGGTTT	CTTACAGCCCAAATTGGTTT	1
ATCATCTTACCAGCTACAAA	ATCATCTTACCAGCTACAAA	1
ACGTCCTCGGGCCCTGCGCG	ACGTCCTCGGGCCCTGCGCG	1
AACGCCAAGCTTACCATGCG	AACGCCAAGCTTACCATGCG	1
CTCACCGAAATAGCAAGTTA	CTCACCGAAATAGCAAGTTA	1
CCCGAACCTGTAGGCACTCG	CCCGAACCTGTAGGCACTCG	1
ACACGGCACATGGCATCCGG	ACACGGCACATGGCATCCGG	1
ACGTAGCATAGGCTGATTGG	ACGTAGCATAGGCTGATTGG	1
TCCGTTGGTCGATTCACAGT	TCCGTTGGTCGATTCACAGT	1
TGCTTTCTGCTGACTCTTGT	TGCTTTCTGCTGACTCTTGT	1
CATTCCACCACCCAATGTAG	CATTCCACCACCCAATGTAG	1
CACGCCGACACGTCCCGCGT	CACGCCGACACGTCCCGCGT	1
TAGCAATAGGAACAGAGATC	TAGCAATAGGAACAGAGATC	1
TGAAAGTACTAGAAAAAGGG	TGAAAGTACTAGAAAAAGGG	1
TTGACAGTCCCAATCACTTG	TTGACAGTCCCAATCACTTG	1
CCCCAGTTAAAATAAGGCTA	CCCCAGTTAAAATAAGGCTA	1
TTTACCTGTGACAGCAACTG	TTTACCTGTGACAGCAACTG	1
AGCCATCACTGCTATCATCC	AGCCATCACTGCTATCATCC	1
GGAACTGACTTCTCAGAGCG	GGAACTGACTTCTCAGAGCG	1
ATGAACAAGCATCTACTGCC	ATGAACAAGCATCTACTGCC	1
TTACATGGGTTCCCCATCTT	TTACATGGGTTCCCCATCTT	1
TCACATCGAGGGTCTGCACG	TCACATCGAGGGTCTGCACG	1
GGGCTAGAATTAGCAAGTTA	GGGCTAGAATTAGCAAGTTA	1
GCAGTACGTCCGAGCTCCCG	GCAGTACGTCCGAGCTCCCG	1
TGAGCACGATGAAACAGACT	TGAGCACGATGAAACAGACT	1
CGAGATGGAGAAGAGTAATT	CGAGATGGAGAAGAGTAATT	1
TTAGCAGTAGAGCTAGAAAT	TTAGCAGTAGAGCTAGAAAT	1
TTACACCAAAGGCCACTGGA	TTACACCAAAGGCCACTGGA	1
GATCGGGAGGGTCCTCCCCG	GATCGGGAGGGTCCTCCCCG	1
ACTCAGTCCACCAATAGTGG	ACTCAGTCCACCAATAGTGG	1
TGTCCTACCTCTACATCTTC	TGTCCTACCTCTACATCTTC	1
AATCCCGTTATCGCAACCAG	AATCCCGTTATCGCAACCAG	1
CCCTGACACAGCCTCGACGT	CCCTGACACAGCCTCGACGT	1
CAACTCCTTCTACTACCCGG	CAACTCCTTCTACTACCCGG	1
AAACTTAGGGCCACTGATTG	AAACTTAGGGCCACTGATTG	1
CATCGATGTCCACCAACATC	CATCGATGTCCACCAACATC	1
CAGCCAAAGACATCCCATTC	CAGCCAAAGACATCCCATTC	1
CCTCCAGTGCAGCCATCATC	CCTCCAGTGCAGCCATCATC	1
TATCCGACCACTTCCTCCCG	TATCCGACCACTTCCTCCCG	1
AGGCAAATGGCAGTATTCAT	AGGCAAATGGCAGTATTCAT	1
TTGTGCCCCGAAATAGCAAG	TTGTGCCCCGAAATAGCAAG	1
TTGTTATTTGACACTATTTA	TTGTTATTTGACACTATTTA	1
CTGCTTCTTATCAGCTTGAA	CTGCTTCTTATCAGCTTGAA	1
GAATCCAAGTCACACGAGTT	GAATCCAAGTCACACGAGTT	1
TTCTGTCTCCTGATCATCGT	TTCTGTCTCCTGATCATCGT	1
GACAACTCAAACTCCGACGT	GACAACTCAAACTCCGACGT	1
TCACCCTGCCCACACTCCCT	TCACCCTGCCCACACTCCCT	1
AGATCACTTACCTCCCCGCT	AGATCACTTACCTCCCCGCT	1
TGTCTACACTATCATGTTTC	TGTCTACACTATCATGTTTC	1
TCTTGTATCCTTAGCTGTTT	TCTTGTATCCTTAGCTGTTT	2
TACTAATAGCAAGTTAAAAT	TACTAATAGCAAGTTAAAAT	1
GATGCAATGACGATCCCCAG	GATGCAATGACGATCCCCAG	1
CCTCCAACTAGCGGCAGTCC	CCTCCAACTAGCGGCAGTCC	1
TGACTTCTGCCTTTGTTTTA	TGACTTCTGCCTTTGTTTTA	1
CCTCGAGTCATCGTCATCGT	CCTCGAGTCATCGTCATCGT	1
GCACTGATCCTAGACCCATT	GCACTGATCCTAGACCCATT	1
CAATCTTGCCTCTAGTTCCG	CAATCTTGCCTCTAGTTCCG	1
GGAGTTATCAACTTGAAAAA	GGAGTTATCAACTTGAAAAA	1
CTGTTTTAGGGCTAGAAATA	CTGTTTTAGGGCTAGAAATA	1
CGCATCGCAGCATCGACAGT	CGCATCGCAGCATCGACAGT	1
ATCCACTTCGTGTCTTATGT	ATCCACTTCGTGTCTTATGT	1
TCCACGATGTACTCGTCCCG	TCCACGATGTACTCGTCCCG	1
ACCTTGAGTCCTCTATAGCG	ACCTTGAGTCCTCTATAGCG	1
TGTGGTGGGCATCTGTTCAG	TGTGGTGGGCATCTGTTCAG	1
CACACTAGACGCCAGATGCG	CACACTAGACGCCAGATGCG	1
CCCGTACCTGTCCGACACGT	CCCGTACCTGTCCGACACGT	1
TCGTGTCGGAAGTGTCTCAG	TCGTGTCGGAAGTGTCTCAG	1
TTCAAGCAGGTTAAAATAAG	TTCAAGCAGGTTAAAATAAG	1
ACATGTCGTTTTAGAGCTAG	ACATGTCGTTTTAGAGCTAG	1
TTTACCCGCCGAAGCCATAG	TTTACCCGCCGAAGCCATAG	1
ACAAGCGTCCTCAACCAGCA	ACAAGCGTCCTCAACCAGCA	1
ACATGGTCAATATGAAAGCG	ACATGGTCAATATGAAAGCG	1
GGCTCCACATAAGATGTATT	GGCTCCACATAAGATGTATT	1
TAAGTTCTTCTTGTCCTCGT	TAAGTTCTTCTTGTCCTCGT	1
CGCCCCGACAGTTTTAGAGC	CGCCCCGACAGTTTTAGAGC	1
CCTCTTCTGCCTACAGTACC	CCTCTTCTGCCTACAGTACC	1
GCCACCTTTGGGTCCGCTTT	GCCACCTTTGGGTCCGCTTT	1
TCAGGCTAAAACTCCAGTTT	TCAGGCTAAAACTCCAGTTT	1
TTCAACCCTCACTTCGATTG	TTCAACCCTCACTTCGATTG	1
ACCACTGTGCCATCATTCCG	ACCACTGTGCCATCATTCCG	1
AACACTGCCCGTCTAACTTG	AACACTGCCCGTCTAACTTG	1
AATCACTGCCTGAAGACGGT	AATCACTGCCTGAAGACGGT	1
TCGAATCTGCCATGCGAACG	TCGAATCTGCCATGCGAACG	1
GCCCACCCACCTCGTTATTT	GCCCACCCACCTCGTTATTT	1
CAGTGGCCGTCACGGTCAGC	CAGTGGCCGTCACGGTCAGC	1
TTGAAGACCGAATGATCTGT	TTGAAGACCGAATGATCTGT	1
GTCAAAGTACGAGTCTATGT	GTCAAAGTACGAGTCTATGT	1
TTTGTGTGTTCATTGAAGAA	TTTGTGTGTTCATTGAAGAA	1
AGACCTACAAATTCCGCACT	AGACCTACAAATTCCGCACT	1
AGTTATAATAAGGCTAGTCC	AGTTATAATAAGGCTAGTCC	1
AGCTGACGCCGACCTTCGCG	AGCTGACGCCGACCTTCGCG	1
GTGTTAAGCCCTCCTCATGT	GTGTTAAGCCCTCCTCATGT	1
TTACTGTTGCCCGTTTTAGA	TTACTGTTGCCCGTTTTAGA	1
CATTCAACAGCTCCTCTGCC	CATTCAACAGCTCCTCTGCC	1
GTAGTAGCTGTCCAGTCCGT	GTAGTAGCTGTCCAGTCCGT	3
GTCGCCGATCACGAAGTAGA	GTCGCCGATCACGAAGTAGA	1
CGTGTCCAGTCCCGAAGTGA	CGTGTCCAGTCCCGAAGTGA	1
ATGGAGAAGACAGTTTTAGA	ATGGAGAAGACAGTTTTAGA	1
TACATCAACCCGCCGTCACT	TACATCAACCCGCCGTCACT	1
GGACCGAGCCAATGAGCTCG	GGACCGAGCCAATGAGCTCG	1
CACTCACCATGATCCTCGTA	CACTCACCATGATCCTCGTA	1
TTGGCAGAGAATCCAAGTCG	TTGGCAGAGAATCCAAGTCG	1
CTTTGAGACATGCGTTTTAG	CTTTGAGACATGCGTTTTAG	1
TTTAGAGCTAGAAATAGCAA	TTTAGAGCTAGAAATAGCAA	1
TTCTACCAGCAATCTCCATG	TTCTACCAGCAATCTCCATG	1
CTGCTCCACCGTCATGCGCC	CTGCTCCACCGTCATGCGCC	1
CTAGGCCATGTAGCCCCTGT	CTAGGCCATGTAGCCCCTGT	1
ATGCAACGACGTATTCCACG	ATGCAACGACGTATTCCACG	1
TAGTTCTCAAACCAAGTTAA	TAGTTCTCAAACCAAGTTAA	1
CAGCCACTTACCTGAGCCCG	CAGCCACTTACCTGAGCCCG	1
TCAGTGGAGTGAGCTGACCC	TCAGTGGAGTGAGCTGACCC	1
TCCATTTAAATAGCAAGTTA	TCCATTTAAATAGCAAGTTA	1
CACCCTATTTCCGTGTATAT	CACCCTATTTCCGTGTATAT	1
TGGCAGGCGCGGCGAGTCCC	TGGCAGGCGCGGCGAGTCCC	1
TTATTCTCCAGGCACCTACG	TTATTCTCCAGGCACCTACG	1
CATGCCATCATCTTCCGAGT	CATGCCATCATCTTCCGAGT	1
CCACCCAACTAAACCACTTT	CCACCCAACTAAACCACTTT	1
TTCATGACTCCACTAAAAGT	TTCATGACTCCACTAAAAGT	1
GCTCTTCTACTTCGTCAAGT	GCTCTTCTACTTCGTCAAGT	1
CGCAGTCATCATCAACTGCC	CGCAGTCATCATCAACTGCC	1
CCTCTGTGTTGACACTAGTG	CCTCTGTGTTGACACTAGTG	1
TCCCGTCCTGCTAAGAGTGT	TCCCGTCCTGCTAAGAGTGT	1
CGGAGATGTCGTTGTTCTGT	CGGAGATGTCGTTGTTCTGT	1
CGCTGGACTCGTCCTCAGGT	CGCTGGACTCGTCCTCAGGT	1
CAATTAGGGCATGGACCGTT	CAATTAGGGCATGGACCGTT	1
TTTTACGTTGACCAGTGATT	TTTTACGTTGACCAGTGATT	1
TCTCATAATCTCCTTGTATG	TCTCATAATCTCCTTGTATG	1
TTGTGAACTTTGTCCCCATA	TTGTGAACTTTGTCCCCATA	1
GGTGACCATCTACCACCTTG	GGTGACCATCTACCACCTTG	1
CGACTTTTCCTACTTGTATT	CGACTTTTCCTACTTGTATT	1
TGTCAACTTGATCAGTCTGG	TGTCAACTTGATCAGTCTGG	1
ACTTACCATCCTGTCAGAGG	ACTTACCATCCTGTCAGAGG	1
ATACTGTGAACAAGGACTTT	ATACTGTGAACAAGGACTTT	1
CCCACAACTTCATGCTGCGT	CCCACAACTTCATGCTGCGT	1
TACGACTACTCGGAGCCCGT	TACGACTACTCGGAGCCCGT	1
GGACTGCCCCCTCACCTATT	GGACTGCCCCCTCACCTATT	1
TCCGCGCCTCGTTCACTCTT	TCCGCGCCTCGTTCACTCTT	1
CGAGACCATCAACGTGGACC	CGAGACCATCAACGTGGACC	1
TGCCGCGCGCGCAATGCATG	TGCCGCGCGCGCAATGCATG	1
GCCCCACCTGACATCCGCGG	GCCCCACCTGACATCCGCGG	1
GTAGAAGGATCACCACCTTC	GTAGAAGGATCACCACCTTC	1
CTCTGCTGTCCCGCTTTGTT	CTCTGCTGTCCCGCTTTGTT	1
TTGAATCGGGTACGGAGCTC	TTGAATCGGGTACGGAGCTC	1
CAACGCAAGTTAAAATAAGG	CAACGCAAGTTAAAATAAGG	1
CGTCCTACTCGACCAGGTTT	CGTCCTACTCGACCAGGTTT	1
GTCATTCTGACAAATCACGA	GTCATTCTGACAAATCACGA	1
TACCAGAAGACGTCCCATCA	TACCAGAAGACGTCCCATCA	1
TGCGATCTGCCCCGCGTGGT	TGCGATCTGCCCCGCGTGGT	1
CTCGAGCAGAGCGCAATCGT	CTCGAGCAGAGCGCAATCGT	1
GCAAAGCGGCCATGCGTTCT	GCAAAGCGGCCATGCGTTCT	1
TTGACACAAAGCCAGTACCG	TTGACACAAAGCCAGTACCG	1
TAGCACCAGTAGGCCGTTAT	TAGCACCAGTAGGCCGTTAT	1
TTCCACATCGATCACGTCTG	TTCCACATCGATCACGTCTG	1
CTTACCTTCATTCGGGACAG	CTTACCTTCATTCGGGACAG	1
TGGCATATTTTAAATGGCCG	TGGCATATTTTAAATGGCCG	1
CCAAGTACCGCTGGGTCGGG	CCAAGTACCGCTGGGTCGGG	1
AGTCCTCTGTAACACTGTCG	AGTCCTCTGTAACACTGTCG	1
CGACACCAACATCGCTGACC	CGACACCAACATCGCTGACC	1
TTGCAGTCTCGAAAATAGCA	TTGCAGTCTCGAAAATAGCA	1
CCACCCATGGGCACGCAGTT	CCACCCATGGGCACGCAGTT	1
TACCAGACTGCTTGTTTCGT	TACCAGACTGCTTGTTTCGT	1
CCTCCAGTCCCATGATGCAG	CCTCCAGTCCCATGATGCAG	1
TACCTCATCCGACACCCGTT	TACCTCATCCGACACCCGTT	1
CAGGGGGTAGCACGGAGATC	CAGGGGGTAGCACGGAGATC	1
TTAACCAGCCCCTTCAGTTT	TTAACCAGCCCCTTCAGTTT	1
GTGCGGCATCAACTATGATT	GTGCGGCATCAACTATGATT	1
CTCGATGTCGATGCTCCGCG	CTCGATGTCGATGCTCCGCG	1
GCGACCCCTTATGAAGCTGT	GCGACCCCTTATGAAGCTGT	1
CACGGAGTCTTCTTCGTAGT	CACGGAGTCTTCTTCGTAGT	1
CACCATCTCACACGTTTTAG	CACCATCTCACACGTTTTAG	1
TACTGTGTTACACTATAGTT	TACTGTGTTACACTATAGTT	1
TTCCTGCTTACAGCCTCAGT	TTCCTGCTTACAGCCTCAGT	1
GTATGAACTAGTGCACACGT	GTATGAACTAGTGCACACGT	1
GCGCCCACCGACTACGTCAA	GCGCCCACCGACTACGTCAA	1
TCAGTTGCTATGTCCCCACG	TCAGTTGCTATGTCCCCACG	1
AGATGGCTTGCGCTGACACT	AGATGGCTTGCGCTGACACT	1
GTAGCCTCGATGACGGCGGT	GTAGCCTCGATGACGGCGGT	1
GCCCTATTCGAATGCAACGG	GCCCTATTCGAATGCAACGG	1
GGCCACGTTATCCACTTGAA	GGCCACGTTATCCACTTGAA	1
GGGAATTGTGGTTTTCTCTT	GGGAATTGTGGTTTTCTCTT	1
CGCTGCCATCACCTTGAAAA	CGCTGCCATCACCTTGAAAA	1
CTTGCACTACCAAGTCATCA	CTTGCACTACCAAGTCATCA	1
TGCATGGTCCGTTATCAACT	TGCATGGTCCGTTATCAACT	1
TTTCACAGGCGTCGGCATTC	TTTCACAGGCGTCGGCATTC	1
CACTTAGAGCTAGAAATAGC	CACTTAGAGCTAGAAATAGC	1
AGGACGCAGCTGCCTGCCCG	AGGACGCAGCTGCCTGCCCG	1
CTTGCTGCCCCCCTGCCCGT	CTTGCTGCCCCCCTGCCCGT	1
ACACCGATACGTGACACTAG	ACACCGATACGTGACACTAG	1
CTCCCGTTCGCGTCGCCGAG	CTCCCGTTCGCGTCGCCGAG	1
GCAGTTCCCTGACAGCTATG	GCAGTTCCCTGACAGCTATG	1
CCTGAATTTTCTTGACACGG	CCTGAATTTTCTTGACACGG	1
GCCCGAAGTTTTAGAGCTAG	GCCCGAAGTTTTAGAGCTAG	1
TCCAGTGCCCGAACTGCACT	TCCAGTGCCCGAACTGCACT	1
CTGGTCTCCCTGCACTGTTT	CTGGTCTCCCTGCACTGTTT	1
ACACAAGCATCCACGTCCGG	ACACAAGCATCCACGTCCGG	1
GCCGGGACTTGTCACTATGT	GCCGGGACTTGTCACTATGT	1
CTAGCCAAACATCATGTTAA	CTAGCCAAACATCATGTTAA	1
GTATGGCAAATAAGAACACG	GTATGGCAAATAAGAACACG	1
ATCCTACCGACCTGCCCACT	ATCCTACCGACCTGCCCACT	1
CGATGCGTTACCTTCCTTAG	CGATGCGTTACCTTCCTTAG	1
CTTCCTCCTCATCTCATCTG	CTTCCTCCTCATCTCATCTG	1
CGGTTGCAAAACTTTCAGAG	CGGTTGCAAAACTTTCAGAG	1
TTTCCTGGGAGAGTACCTTC	TTTCCTGGGAGAGTACCTTC	1
TTCAACGCCCCTTTGATGTG	TTCAACGCCCCTTTGATGTG	1
TATATAACATTAGTGTACCG	TATATAACATTAGTGTACCG	1
GTGTACCTCCCTACGAGCCG	GTGTACCTCCCTACGAGCCG	1
GTTCTGAGCCACGTTATCTG	GTTCTGAGCCACGTTATCTG	1
TGTACCCGATGCTCTCCGTT	TGTACCCGATGCTCTCCGTT	1
GGGGAACTCACCCAGCCCGA	GGGGAACTCACCCAGCCCGA	1
CATCGACCAGTCAGTCTCTG	CATCGACCAGTCAGTCTCTG	1
TGCCACAATCTGGAGGTTTA	TGCCACAATCTGGAGGTTTA	1
CCTCCATCATCCAACATGCT	CCTCCATCATCCAACATGCT	1
CTCACAGATAGCCACCGCGG	CTCACAGATAGCCACCGCGG	1
GCAAGTTACAATAAGGCTAG	GCAAGTTACAATAAGGCTAG	1
TCCCTATAGAGCTAGAAATA	TCCCTATAGAGCTAGAAATA	1
TCGTGTAGCAAGTTAAAATA	TCGTGTAGCAAGTTAAAATA	1
ACATGACATACCCCTTGAAG	ACATGACATACCCCTTGAAG	1
ACCTTAATGACTACGTTTAG	ACCTTAATGACTACGTTTAG	1
TTCCACTTCCTTATCGCTAT	TTCCACTTCCTTATCGCTAT	1
GAGCTAGAAATAGCAAGTTA	GAGCTAGAAATAGCAAGTTA	1
TTCCGAGGCACGGCCACGTG	TTCCGAGGCACGGCCACGTG	1
TCTCAGAGTAATTCTTTAAA	TCTCAGAGTAATTCTTTAAA	1
CTCCATCGACGTCATAATGT	CTCCATCGACGTCATAATGT	1
GCGGGAGCGATACCACATCC	GCGGGAGCGATACCACATCC	1
AACAACACAGCTAATGCATA	AACAACACAGCTAATGCATA	1
GTGTGTGATCTCAGCCACGG	GTGTGTGATCTCAGCCACGG	1
ATTGTCCGGCGAGGACGTGC	ATTGTCCGGCGAGGACGTGC	1
ACTTGACCCAGCTCATCTGG	ACTTGACCCAGCTCATCTGG	1
TCTGTAGATGATGACGATCG	TCTGTAGATGATGACGATCG	1
GCCTGTACTGGTACATCCCG	GCCTGTACTGGTACATCCCG	1
GCCATCGTCTTATCCGCACC	GCCATCGTCTTATCCGCACC	1
CGCCCTACCTGCCGAGCCGC	CGCCCTACCTGCCGAGCCGC	1
CTGCCGTGCACGATGTTATC	CTGCCGTGCACGATGTTATC	1
TACCCATTTAACTGCTATTG	TACCCATTTAACTGCTATTG	1
CAAAGAACTGCACGTGATAC	CAAAGAACTGCACGTGATAC	1
TAAGCGAATAAACGTTGATA	TAAGCGAATAAACGTTGATA	1
CGACTCTTGGCCAATCCCCT	CGACTCTTGGCCAATCCCCT	1
GCACTCAGTGCGAAGTCAAG	GCACTCAGTGCGAAGTCAAG	1
ACACTGCGTGTCTCCCAGTT	ACACTGCGTGTCTCCCAGTT	1
CCGTCCCACCCGACTTATTG	CCGTCCCACCCGACTTATTG	1
TGTCACAGTTCTCGCAGCAC	TGTCACAGTTCTCGCAGCAC	1
CGCCAGCATCGAAAGGTACG	CGCCAGCATCGAAAGGTACG	1
GCAGCCGTATCAACTTGAAA	GCAGCCGTATCAACTTGAAA	1
CAATGGCGGCAGTCGCGCTC	CAATGGCGGCAGTCGCGCTC	1
TTTACATGACTTCCAAGCGT	TTTACATGACTTCCAAGCGT	1
GTGTCCGTTCTCAACTTGAA	GTGTCCGTTCTCAACTTGAA	1
CATTGGGCATTAACATTTGT	CATTGGGCATTAACATTTGT	1
ACCGAACATGCGATCCTCCG	ACCGAACATGCGATCCTCCG	1
GTTGCACGTAAACTTGCGCG	GTTGCACGTAAACTTGCGCG	1
TGCAAACTTACCTGGGGCTG	TGCAAACTTACCTGGGGCTG	1
CGGCATTCATGTACCTCCAG	CGGCATTCATGTACCTCCAG	1
TCTGGCAGGCCACCGTTTAG	TCTGGCAGGCCACCGTTTAG	1
TCCGTTTTTTCGAGTTTAGA	TCCGTTTTTTCGAGTTTAGA	1
TGCGATGCTGACGTTCTCAG	TGCGATGCTGACGTTCTCAG	1
TCGCCAAGAGGGCGCAATCG	TCGCCAAGAGGGCGCAATCG	1
TAACAGAGTTTGCCATGCTC	TAACAGAGTTTGCCATGCTC	1
CAGCGCTAGCAGACCAGGTT	CAGCGCTAGCAGACCAGGTT	1
CGTCACATCATTCAACTCCT	CGTCACATCATTCAACTCCT	1
AACGAAACACCTTCCGATGT	AACGAAACACCTTCCGATGT	1
TCACCCGCTCATCAAATCCG	TCACCCGCTCATCAAATCCG	1
CTGACCGCCCTTAGCGTTAG	CTGACCGCCCTTAGCGTTAG	1
AACACCTGTCAGCCGACTGT	AACACCTGTCAGCCGACTGT	1
AATTCCTCTAGAGCTAGAAA	AATTCCTCTAGAGCTAGAAA	1
TCCGGCAGCAGGTCTCGTAC	TCCGGCAGCAGGTCTCGTAC	1
ACCGGCAGAAGCCCCTGACG	ACCGGCAGAAGCCCCTGACG	1
GCGCCCTGCGCTCCTTCCGC	GCGCCCTGCGCTCCTTCCGC	1
AACTACTGACGTCGCACTAG	AACTACTGACGTCGCACTAG	1
GCCCTGAGAGACACCGCCTG	GCCCTGAGAGACACCGCCTG	1
TTCAAGCAAGTTAAAATAAG	TTCAAGCAAGTTAAAATAAG	1
TGGGCACTGACCGTGGGCAG	TGGGCACTGACCGTGGGCAG	1
TGAAGTCCTGCGCGATCTCA	TGAAGTCCTGCGCGATCTCA	1
TCGCGACTACAGAGCCCCGG	TCGCGACTACAGAGCCCCGG	1
CAGCGCCATCTCGTAGGTTA	CAGCGCCATCTCGTAGGTTA	1
ACCTCCAGGCTGGTCCGTTA	ACCTCCAGGCTGGTCCGTTA	1
AGCGACTACGACTCTGTTGT	AGCGACTACGACTCTGTTGT	1
TGAAGATTGAAAGTTAAAAT	TGAAGATTGAAAGTTAAAAT	1
CTTGTCTCAAATCAGCTACT	CTTGTCTCAAATCAGCTACT	1
GCGTTTTCATCCTGTCGCGT	GCGTTTTCATCCTGTCGCGT	1
ACTTGAGACAAGCTCTCGCG	ACTTGAGACAAGCTCTCGCG	1
TCCAAAACTCCTTTACCAAG	TCCAAAACTCCTTTACCAAG	1
TGACCTCGACTGCTCTGACG	TGACCTCGACTGCTCTGACG	1
TCTTGTTCCGATACACCGAT	TCTTGTTCCGATACACCGAT	1
ACGCTTGAGCGACGAGACCG	ACGCTTGAGCGACGAGACCG	1
ACGCCCAGCGCTCGTACACT	ACGCCCAGCGCTCGTACACT	1
TTGCGAATGTTACCATCTCG	TTGCGAATGTTACCATCTCG	1
ATAACGTGATCACAGACATG	ATAACGTGATCACAGACATG	1
ACGAGATGTCCCGCGCCAGG	ACGAGATGTCCCGCGCCAGG	1
AACTCGCGATGCCATCTCCG	AACTCGCGATGCCATCTCCG	1
TGTTCTCCTGCGCCTGCACG	TGTTCTCCTGCGCCTGCACG	1
ACTTACCAACTACCATATGT	ACTTACCAACTACCATATGT	1
AACCACTGCGTCCTTATCGT	AACCACTGCGTCCTTATCGT	1
CTGTGACCCATGCCTCCAAG	CTGTGACCCATGCCTCCAAG	1
TAGCTTACTCGAAATTCACG	TAGCTTACTCGAAATTCACG	1
GTGACTCCAGCTATCCAGGT	GTGACTCCAGCTATCCAGGT	1
TACTCACTCGGCAAACTTGG	TACTCACTCGGCAAACTTGG	1
CTTCAAGTTAAAATACGGCT	CTTCAAGTTAAAATACGGCT	1
ACCCCATCCTTTCATTGAGG	ACCCCATCCTTTCATTGAGG	1
ACACCATTTAGAGCGTGTCT	ACACCATTTAGAGCGTGTCT	1
TAGGCTTACCTAGTTTGCAC	TAGGCTTACCTAGTTTGCAC	1
CTCCAGAACCTGCCCAAGAA	CTCCAGAACCTGCCCAAGAA	1
TTTTCCAGCACTCGAATGCG	TTTTCCAGCACTCGAATGCG	1
TCCCGCGAGACGAGCTGCGT	TCCCGCGAGACGAGCTGCGT	1
CTCGTCGCAGCCCACAAGCA	CTCGTCGCAGCCCACAAGCA	1
CCCCCCCACTCTCAACGGGT	CCCCCCCACTCTCAACGGGT	1
TCTCTCCGCGCAGCAACTCA	TCTCTCCGCGCAGCAACTCA	1
GCTTACATAGCAAATCTATG	GCTTACATAGCAAATCTATG	1
TCTGGTGATCTCTCCCGAGT	TCTGGTGATCTCTCCCGAGT	1
CCGTATCCCCACTCTCATCA	CCGTATCCCCACTCTCATCA	1
ACATTTGTTCTGCAAAGACA	ACATTTGTTCTGCAAAGACA	1
ATCATGTTTCTAAAGCCGCG	ATCATGTTTCTAAAGCCGCG	1
TTCCAAAATACGACTTTACC	TTCCAAAATACGACTTTACC	1
ATCAGTTTTAGAGCTAGAAA	ATCAGTTTTAGAGCTAGAAA	1
CCGTTCTCAACTTGAAAAAG	CCGTTCTCAACTTGAAAAAG	1
CTGCATATCTTCGAGATGCT	CTGCATATCTTCGAGATGCT	1
ACTTCGACACGACCTCTACG	ACTTCGACACGACCTCTACG	1
CTCCTCGAAGGGCCGACACG	CTCCTCGAAGGGCCGACACG	1
TGTGTACAGCTCTCCTCCGT	TGTGTACAGCTCTCCTCCGT	1
CTTATAGTCAGCCTCAAAAG	CTTATAGTCAGCCTCAAAAG	1
TCCGCAGCCCTCCACACGTA	TCCGCAGCCCTCCACACGTA	1
CCCGATGATCTCGATGCCCG	CCCGATGATCTCGATGCCCG	1
TCTCCTATCAAGGCCATTCT	TCTCCTATCAAGGCCATTCT	1
AGGATCCTGAGACGTTCCTC	AGGATCCTGAGACGTTCCTC	1
TTCCCTATCAGTAGAAATAG	TTCCCTATCAGTAGAAATAG	1
CTGGTCTCGCCGGTAGCTAT	CTGGTCTCGCCGGTAGCTAT	1
